{
    "levelName": "Level 1",
    "activeEnvironmentName": "Environment_2",
    "activeCells": {
        "G": [
            "G:10:10",
            "G:10:2",
            "G:2:8",
            "G:2:4",
            "G:5:10",
            "G:4:2",
            "G:8:6",
            "G:4:9",
            "G:6:1",
            "G:7:10",
            "G:2:10",
            "G:4:3",
            "G:10:7",
            "G:5:9",
            "G:4:4",
            "G:10:1",
            "G:3:1",
            "G:6:6",
            "G:10:6",
            "G:3:9",
            "G:3:8",
            "G:10:5",
            "G:8:2",
            "G:8:5",
            "G:8:4",
            "G:4:10",
            "G:8:3",
            "G:4:8",
            "G:2:5",
            "G:4:1",
            "G:10:4",
            "G:5:8",
            "G:7:1",
            "G:8:1",
            "G:5:1",
            "G:2:3",
            "G:2:7",
            "G:2:1",
            "G:6:8",
            "G:8:8",
            "G:6:7",
            "G:8:7",
            "G:6:10",
            "G:6:3",
            "G:6:5",
            "G:4:6",
            "G:10:3",
            "G:6:4",
            "G:1:1",
            "G:8:10",
            "G:10:8",
            "G:4:5",
            "G:6:9",
            "G:10:9",
            "G:1:10",
            "G:9:10",
            "G:3:10",
            "G:2:6"
        ],
        "R": [
            "R:9:7",
            "R:7:9",
            "R:4:7",
            "R:5:3",
            "R:3:7",
            "R:3:6",
            "R:9:6",
            "R:9:2",
            "R:6:2",
            "R:1:8",
            "R:7:2",
            "R:9:9",
            "R:1:5",
            "R:9:1",
            "R:9:3",
            "R:7:6",
            "R:1:2",
            "R:5:6",
            "R:2:9",
            "R:8:9",
            "R:4:10",
            "R:5:7",
            "R:9:10",
            "R:1:4",
            "R:3:2",
            "R:1:6",
            "R:2:2",
            "R:9:8",
            "R:7:8",
            "R:9:4",
            "R:7:7",
            "R:2:10",
            "R:3:4",
            "R:7:3",
            "R:3:3",
            "R:7:5",
            "R:5:2",
            "R:9:5",
            "R:1:3",
            "R:1:9",
            "R:3:5",
            "R:5:4",
            "R:5:5",
            "R:7:4",
            "R:1:7"
        ]
    }
}